R 1000   1000
NO NNNNN
WE WWWWW
EA EEEEE
SO SSSSS

S SPSPSP
F 220,100,0
C 225,30,0

11111111111
10220220001
10000000001
10002200001
10000000001
1000N000001
11111111111
