R 1000   1000
NO NNNNN
WE WWWWW
EA EEEEE
SO SSSSS

S SPSPSP
F 220,10,0
C 90,80,15

111
1S11                                                       1
101           1  1           1                  1
101
101     1       1                     1                                        1         111111111
101                                                                                      111111111
101                                                                                      110101011
101    1                                                                        1        101100101
101                                                             1                        110111111
101                                                             1                        111111111
121              1                                         1
101                                  1                                                    1
1011111
101                                                                                      111111111
101                                                                                      122222211
101    1                                                                        1        100000001
101                                                             1                        122222211
101                                                             1                        111111111
121              1
121                                  1
1111111
