R 1920   1080
NO NNNNN
WE WWWWW
EA EEEEE
SO SSSSS

S SPSPSP
F 220,100,0
C 225,30,0

1111111111111111111111111111111111111111111111111
1S22222222222222222222222222222222222222222222221
1022222222222222222222222222222222222222222222221
1022222222222222222222222222222222222222222222221
1022222222222222222222222222222222222222222222221
1022222222222222222222222222222222222222222222221
1022222222222222222222222222222222222222222222221
1022222222222222222222222222222222222222222222221
1022222222222222222222222222222222222222222222221
1022222222222222222222222222222222222222222222221
1022222222222222222222222222222222222222222222221
1022222222222222222222222222222222222222222222221
1022222222222222222222222222222222222222222222221
1022222222222222222222222222222222222222222222221
1022222222222222222222222222222222222222222222221
1022222222222222222222222222222222222222222222221
1022222222222222222222222222222222222222222222221
1022222222222222222222222222222222222222222222221
1022222222222222222222222222222222222222222222221
1022222222222222222222222222222222222222222222221
1022222222222222222222222222222222222222222222221
1022222222222222222222222222222222222222222222221
1022222222222222222222222222222222222222222222221
1022222222222222222222222222222222222222222222221
1022222222222222222222222222222222222222222222221
1022222222222222222222222222222222222222222222221
1022222222222222222222222222222222222222222222221
1022222222222222222222222222222222222222222222221
1022222222222222222222222222222222222222222222221
1022222222222222222222222222222222222222222222221
1022222222222222222222222222222222222222222222221
1022222222222222222222222222222222222222222222221
1111111111111111111111111111111111111111111111111
