R 1920   1080
NO NNNNN
WE WWWWW
EA EEEEE
SO SSSSS

S SPSPSP
F 220,100,0
C 225,30,0

11111111111111111111111111111111     11111111111111111111111111111111    11111111111111111111111111111111
10000000000000000000000000000001     10000000000000000000000000000001    10000000000000000000000000000001
10000000000000000000000000000001     10000000000000000000000000000001    10000000000000000000000000000001
10011111111111111111111111111001     10011111111111111111111111111001    10011111111111111111111111111001
1001                        1001     1001                        1001    1001                        1001
1001                        1001     1001                        1001    1001                        1001
1001                        1001     1001                        1001    1001                        1001
1001                        1001     1001                        1001    1001                        1001
1001                        1001     1001                        1001    1001                        1001
1001                        1001     1001                        1001    1001                        1001
1001                        1001     1001                        1001    1001                        1001
1001    11111111111111      1001     1001                        1001    1001                        1001
1001    12222222222221      1001     1001                        1001    1001                        1001
1001    12111111111121      1001     1001                        1001    1001                        1001
1001    121        121      1001     1001                        1001    1001                        1001
1001    121        121      1001     1001                        1001    1001                        1001
1001    121        121      1001     1001                        1001    1001                        1001
1001    121        121      1001     1001                        1001    1001                        1001
1001    121        121      1001     1001                        1001    1001                        1001
1001    121        121      1001     1001                        1001    1001                        1001
1001    12111111111121      1001     1001                        1001    1001                        1001
1001    12222222222221      1001     1001                        1001    1001                        1001
1001    11111111111111      1001     1001                        1001    1001                        1001
1001                        1001     1001                        1001    1001                        1001
1001                        1001     1001                        1001    1001                        1001
1001                        1001     1001                        1001    1001                        1001
1001                        1001     1001                        1001    1001                        1001
1001                        1001     1001                        1001    1001                        1001
1001                        1001     1001                        1001    1001                        1001
1001                        1001     1001                        1001    1001                        1001
1001                        1001     1001                        1001    1001                        1001
10011111111111111111111111111001     10011111111111111111111111111001    10011111111111111111111111111001
10000000000000000000000000000001     10000000000000000000000000000001    10000000000000000000000000000001
10000000000000000000000000000001     10000000000000000000000000000001    10000000000000000000000000000001
11111111111111111111111111111111     11111111111111111111111111111111    11111111111111111111111111111111
                                                                                                         
                                                                                                         
                                                                                                         
11111111111111111111111111111111     11111111111111111111111111111111    11111111111111111111111111111111
10000000000000000000000000000001     10000000000000000W00000000000001    10000000000000000000000000000001
10000000000000000000000000000001     10000000000000000000000000000001    10000000000000000000000000000001
10011111111111111111111111111001     10011111111111111111111111111001    10011111111111111111111111111001
1001                        1001     1001                        1001    1001                        1001
1001                        1001     1001                        1001    1001                        1001
1001                        1001     1001                        1001    1001                        1001
1001                        1001     1001                        1001    1001                        1001
1001                        1001     1001                        1001    1001                        1001
1001                        1001     1001                        1001    1001                        1001
1001                        1001     1001                        1001    1001                        1001
1001                        1001     1001                        1001    1001                        1001
1001                        1001     1001                        1001    1001                        1001
1001                        1001     1001                        1001    1001                        1001
1001                        1001     1001                        1001    1001                        1001
1001                        1001     1001                        1001    1001                        1001
1001                        1001     1001                        1001    1001                        1001
1001                        1001     1001                        1001    1001                        1001
1001                        1001     1001                        1001    1001                        1001
1001                        1001     1001                        1001    1001                        1001
1001                        1001     1001                        1001    1001                        1001
1001                        1001     1001                        1001    1001                        1001
1001                        1001     1001                        1001    1001                        1001
1001                        1001     1001                        1001    1001                        1001
1001                        1001     1001                        1001    1001                        1001
1001                        1001     1001                        1001    1001                        1001
1001                        1001     1001                        1001    1001                        1001
1001                        1001     1001                        1001    1001                        1001
1001                        1001     1001                        1001    1001                        1001
1001                        1001     1001                        1001    1001                        1001
1001                        1001     1001                        1001    1001                        1001
10011111111111111111111111111001     10011111111111111111111111111001    10011111111111111111111111111001
10000000000000000000000000000001     10000000000000000000000000000001    10000000000000000000000000000001
10000000000000000000000000000001     10000000000000000000000000000001    10000000000000000000000000000001
11111111111111111111111111111111     11111111111111111111111111111111    11111111111111111111111111111111
                                                                                                         
                                                                                                         
                                                                                                         
11111111111111111111111111111111     11111111111111111111111111111111    11111111111111111111111111111111
10000000000000000000000000000001     10000000000000000000000000000001    10000000000000000000000000000001
10000000000000000000000000000001     10000000000000000000000000000001    10000000000000000000000000000001
10011111111111111111111111111001     10011111111111111111111111111001    10011111111111111111111111111001
1001                        1001     1001                        1001    1001                        1001
1001                        1001     1001                        1001    1001                        1001
1001                        1001     1001                        1001    1001                        1001
1001                        1001     1001                        1001    1001                        1001
1001                        1001     1001                        1001    1001                        1001
1001                        1001     1001                        1001    1001                        1001
1001                        1001     1001                        1001    1001                        1001
1001                        1001     1001                        1001    1001                        1001
1001                        1001     1001                        1001    1001                        1001
1001                        1001     1001                        1001    1001                        1001
1001                        1001     1001                        1001    1001                        1001
1001                        1001     1001                        1001    1001                        1001
1001                        1001     1001                        1001    1001                        1001
1001                        1001     1001                        1001    1001                        1001
1001                        1001     1001                        1001    1001                        1001
1001                        1001     1001                        1001    1001                        1001
1001                        1001     1001                        1001    1001                        1001
1001                        1001     1001                        1001    1001                        1001
1001                        1001     1001                        1001    1001                        1001
1001                        1001     1001                        1001    1001                        1001
1001                        1001     1001                        1001    1001                        1001
1001                        1001     1001                        1001    1001                        1001
1001                        1001     1001                        1001    1001                        1001
1001                        1001     1001                        1001    1001                        1001
1001                        1001     1001                        1001    1001                        1001
1001                        1001     1001                        1001    1001                        1001
1001                        1001     1001                        1001    1001                        1001
10011111111111111111111111111001     10011111111111111111111111111001    10011111111111111111111111111001
10000000000000000000000000000001     10000000000000000000000000000001    10000000000000000000000000000001
10000000000000000000000000000001     10000000000000000000000000000001    10000000000000000000000000000001
11111111111111111111111111111111     11111111111111111111111111111111    11111111111111111111111111111111


