R 1920   1080
NO NNNNN
WE WWWWW
EA EEEEE
SO SSSSS

S SPSPSP
F 220,100,0
C 225,30,0

111111111111111111111111111111111111111111111111111111111111111111111111111111111
100000000000000000000000000000000000000000000000000000000000000000000000000000001
101111111111111111111111111111111111111111111111111111111111111111111111111111101
101                                                                           101
101                                                                           101
101                                                                           101
101                                                                           101
101                                                                           101
101                                                                           101
101                                                                           101
101                                                                           101
101                                                                           101
101                                                                           101
101        2                                                                  101
101                                                                           101
101                                                                           101
101                                                                           101
101                                                                           101
101                                                                           101
101                                                                           101
101                                                                           101
101                                                                           101
101                                                                           101
101                                                                           101
101                                                                           101
101                                                                           101
101                                                                           101
101                                                                           101
101                                                                           101
101                                                                           101
101                                                                           101
101                                                                           101
101                                                                           101
101                                                                           101
101                                                                           101
101                                                                           101
101                                                                           101
101                                                                           101
101                                                                           101
101                                                                           101
101                                                                           101
101                                                                           101
101                                                                           101
101                                                                           101
101                                                                           101
101                                                                           101
101                                                                           101
101                                                                           101
101                                                                           101
101                                                                           101
101                                                                           101
101                                                                           101
101                                                                           101
101                                                                           101
101111111111111111111111111111111111111111111111111111111111111111111111111111101
10000000000000000000000000000000000000E000000000000000000000000000000000000000001
111111111111111111111111111111111111111111111111111111111111111111111111111111111
